NO ./textures/north.xpm
SO ./textures/south.xpm
WE ./textures/west.xpm
EA ./textures/east.xpm

F 210,100,200
C 25,30,0

111111
100101
101001
1100N1
111111
