NO ./textures/north.xpm
SO ./textures/south.xpm
WE ./textures/west.xpm
EA ./textures/east.xpm

F 999,100,0
C 225,30,0

111111
1100N1
111111
