NO ./textures/north.xpm
SO ./textures/south.xpm
WE ./textures/west.xpm
EA ./textures/east.xpm
F 220,100,0
C 0,0,0

111111
1N0 01
111111
