1111
1N01
1111

NO ./textures/wall.xpm
SO ./textures/wall.xpm
WE ./textures/wall.xpm
EA ./textures/wall.xpm
F 220,100,0
C 0,0,0
