NO ./textures/north.xpm
SO ./textures/south.xpm
WE ./textures/west.xpm
EA ./textures/east.xpm
DO ./textures/door.xpm

F 180,120,90
C 80,100,130

1111111111111
1000000000001
111111D111111
1000000000001
111111D111111
10000000000W1
1111111111111
